عيد	[Feast]
عيد الأضحى	[Feast of sacrifice]
عيد الفطر	[Aid Alfitr]
المولد النبوي	[Aid Almawlid/prophet's birthday]
رمضان	[Ramadan]
ليلة القدر	[Sacred Night of Ramadan/27th]
عاشوراء	[Achoura]
عقيقة	[Birth ceremony]
يوم بدر	[Battle of Badr]
ذكرى 11 يناير	[Manifesto of Independence]
ذكرى 20 غشت	[August 20th Anniversary]
عيد الشباب	[Youth Day]
حفل	[Party]
حفلة موسيقية	[Musical party]
ذكرى	[Memorial]
عيد العرش	[Feast of the Throne]
المسيرة الخضراء	[Green March]
حفل الولاء	[Allegiance party]
أب	[Father]
أم	[Mother]
والدين	[Parents]
زوج	[Husband]
زواج	[Marriage]
أخ	[Brother]
أخت	[Sister]
ابن	[Son]
ابن العم	[Cousin]
ساحر	[Wizard]
عجوز	[Old woman]
ولد	[Son]
بنت	[Girl]
خال	[Uncle]
خالة	[Aunt]
متسول	[Beggar]
متشرد	[Tramp/homeless]
جد	[Grandfather/grandpa]
رجل	[Man]
طفل	[Boy]
بيت	[House]
باب	[Door]
مفتاح	[Key]
أغلق	[Close]
آلة التصبين	[Washing machine]
ممر	[Pass/ alley]
أركان	[Headquarter]
أطفأ	[Extinguish]
طرق الباب	[Knock the door]
طنجرة الضغط	[Pressure cooker]
أمتعة	[Luggage]
إناء	[Plate]
تلفاز	[Television]
تلفاز بلازما	[Plasma/LCD TV]
ثلاجة	[Fridge]
تزيين - ديكور	[Decoration]
تلفاز بلازما	[Plasma/LCD TV]
ثلاجة	[Fridge]
ركن	[Corner]
سقف	[Ceiling]
حائط - جدار	[Wall]
صباح الخير	[Good morning]
أبلغ تحياتي	[My greetings]
كيف حالك	[How are you]
بخير	[Alright/fine]
جيد	[Good]
شكرا	[Thanks/thank you]
الحمد لله	[Thank God]
السلام عليكم	[Peace be upon you]
باختصار	[In brief]
بصحة جيدة	[In good health]
لا مبالي	[Careless]
أعطني	[Give me]
غاب عن ذهنه	[Forgot]
ما العمل	[So what]
سنرى	[Will see]
من هذا	[From this/that]
ماذا	[What]
هكذا	[Like this/that]
كم	[How much/many]
من الضروري	[Necessary]
بالضبط	[Exactly]
عاد - رجع	[Return/got back]
الذهاب والإياب	[Go back and forth]
توقف	[Stop]
زحف	[Crawl]
سكة حديدية	[Railway]
قارب	[Boat]
قاعة الحفلات	[Concert hall]
ماليزيا	[Malaysia]
محطة القطار	[Train station]
محطة الوقود	[Gaz station]
محل تجاري	[Commercial shop/store]
مرافق	[Companion]
مع	[With]
منارة	[Minaret]
موقف السيارات	[Parking]
سيارة بوجو	[Peugot car]
سيارة غولف	[Golf car]
تكلم	[Speak]
ناقش	[Discuss]
إشارة	[Sign]
أبجدية	[Alphabet]
آسف	[Sorry]
كلمة	[Word]
جملة	[Sentence]
شرح - فسر	[Explain]
صوت	[Voice]
أعلم	[Notify]
رسالة	[Letter]
سامح	[Forgive]
اتصل	[Call/contact]
اتصال هاتفي	[Phone call]
ارتبط	[Link]
كاميرا	[Camera]
لقاء	[Meeting]
بارابول	[Sattelite dish]
بريد إلكتروني	[E-mail]
سؤال	[Question]
جواب	[Answer]
أمر	[Order]
سافر	[Travel]
عطلة	[Holiday/vacation]
سياحة	[Tourism]
أجنبي	[Foreigner/outsider]
فندق - نزل	[Hotel]
بيانو	[Piano]
تأرجح	[Swinging]
تجول	[Walking]
تحفة فنية	[Antiquity]
رمي الجلة	[Discus/shot put]
رمي الرمح	[Javelin]
سباحة	[Swimming]
شاطئ	[Beach]
تمدد	[Lay down]
تنزه سيرا	[Walking]
غولف	[Golf]
فروسية	[Horse riding]
فولكلور	[Folklore]
فيلم	[Film/movie]
قفز	[Jump]
قلد	[Imitate]
رأس	[Head]
شعر	[Hair]
عين	[Eye]
أنف	[Nose]
أذن	[Ear]
فم	[Mouth]
أسنان	[Teeth]
وجه	[Face]
قياس الضغط	[Pressure gauge]
لسان	[Tongue]
عنق	[Neck]
حنجرة	[Throat]
جبهة	[Front]
بشرة	[Skin]
شارب	[Moustache]
مستشفى خاص	[Private hospital]
نزف	[Bleed]
مستعجلات	[Emergencies/casualty department]
حاجب	[Eyebrow]
ذقن	[Chin]
كتف	[Shoulder]
أمل	[Hope]
فجأة - فوجئ	[Suddenly]
اندهش	[Surprised]
قلق	[Worry]
بكى	[Cry]
رمز	[Symbol]
ضحك	[Laughter]
عشاق	[Lovers]
عناق	[Hug]
غاضب	[Angry]
اشمئزاز	[Disgusting]
كئيب - حزين	[Sad]
حزن	[Sadness]
فهم	[Understanding]
انزعاج	[Worry]
نسي	[Forgot]
إغراء	[Seduction/temtation]
أحب - عشق	[Love/adore]
كره - بغض	[Hatred]
صدق	[Truth]
مسرور - فرح	[Happy]
حيوان	[Animal]
ذيل - ذنب	[Tail]
كلب	[Dog]
قطة	[Cat]
الحمار الوحشي	[Zebra]
جرادة	[Jerrada]
أيل	[Deer]
سبات	[Sleeping/hibernation]
نعامة	[Ostrich]
عنكبوت	[Spider]
فرس النهر	[Hippopotamus]
قندس	[Beaver]
صقر	[Eagle]
عصفور	[Bird]
سمك الراية	[Stingray]
غراب	[Raven]
غزال	[Gazelle]
بطريق	[Penguin]
قصير	[Short]
سريع	[Quick/swift]
طويل	[Tall]
لغاية	[In order to]
زمن	[Time]
دقيق	[Flour]
فاتح محرم	[Moharrem]
فبراير	[February]
ماي	[May]
رأس السنة الميلادية	[New Year eve]
راهن	[Bet]
شتنبر	[September]
أكتوبر	[October]
غشت	[August]
نونبر	[November]
تقدم	[Progress]
لاحقا	[Later]
باكرا	[Early]
قبل	[Before]
حالا	[Now]
طريق	[Way/path]
جبل	[Mountain]
حجر	[Stone/rock]
تراب	[Soil]
ماء	[Water]
نبت	[Grow]
جزر	[Carrot]
جزيرة	[Island]
وردة	[Flower]
عاصفة	[Tempest]
ورقة نبات	[Leaf]
كسوف	[Eclipse]
نخلة	[Palm tree]
أمواج	[Waves]
برق - عاصفة	[Lightning]
بئر	[Pit]
برد	[Cold]
برد قارس	[Cold]
نهر	[River]
شلال	[Waterfalls]
بحر	[Sea]
فقير	[Poor]
فاتورة	[Bill]
دكان - متجر	[Shop/store]
محاسبة	[Accounting]
ميكانيكي	[Mechanic]
أخصائي الصدر	[Pneumologist]
أخصائي العيون	[Ophthalmologist]
أخصائي المعدة	[Gastroenterologist]
أخصائي الولادة	[Gynecologist]
رئيس الخدم	[Butler]
راعي البقر	[Cowboy]
ربان الطائرة	[Pilot]
زيادة الأجور	[Salary raising/raise]
سائق	[Driver]
تسريح	[Firing]
مطبعة	[Printing]
أكل	[Eat]
فطور	[Breakfast]
وجبة الغذاء	[Lunch]
وجبة العشاء	[Dinner]
بصل	[Onions]
جلبانة	[Peas]
حلو	[Sweet]
حلوى عيد الميلادي	[Birthday cake]
قوق	[Artichot]
لوز	[Almonds]
ليبتون	[Lipton tea]
دانون	[Yogurt]
هلالية	[Crescent]
جائع	[Hungry]
شكولاطة	[Chocolate]
ذاق	[Taste]
لذيذ	[Delicious]
شبع	[Satiation]
عصير	[Juice]
علبة سمك	[Fish can/tin]
حلوى	[Cake]
الله	[Allah]
ديانات	[Religions]
إسلام	[Islam]
مسلمون	[Muslim people]
مسيحية	[Christianity]
يهودية	[Jewish]
قرآن	[Koran]
تجويد	[Chanting/tajwid]
ركع	[Kneel]
سورة	[Verse]
آية كريمة	[Holy verse]
أركان الإسلام	[Pillars of Islam]
تشهد	[Testify]
الرسول	[The prophet]
إمام	[Imam/priest]
مسجد	[Mosque]
كنيسة	[Church]
مؤذن	[Prayer caller]
محراب	[Prayer niche/Mihrab]
الوقوف بعرفة	[Arafa Day]
صلاة	[Prayer]
صلاة الفجر	[Dawn prayer]
عدد	[Number]
لباس	[Garment/clothes]
نزع اللباس	[Take off/undress]
قميص بعنق ملفوف	[Turtle neck]
زر	[Button]
سد الأزرار	[Buttoning]
سروال	[Pants/trousers]
سروال قصير	[Shorts]
حزام	[Belt]
قميص	[Shirt]
سروال دجين	[Jeans]
ربطة عنق	[Tie]
قبعة عصرية	[Cap]
بذلة	[Suit]
معطف	[Coat]
سوار	[Bracelet]
قفاز	[Glove]
وشاح - كشكول	[Scarf]
حذاء	[Shoes]
جورب	[Sock]
نظارات	[Glasses]
نعل	[Shoe]
مدرسة	[School]
امتحان - اختبار	[Exam]
ابتدائي	[Elementary]
بركار	[Volcano]
تربية	[Education]
تعليم	[Tutoring/education]
أستاذ - مدرس	[Teacher/tutor]
كتب	[Books]
طالب	[Student]
قلم ملون	[Crayon]
لغة برايل	[Braille]
قراءة	[Reading]
كتاب	[Book]
ركز	[Concentrate]
طالب داخلي	[Boarder]
علوم	[Science]
قلم حبر	[Pen]
قلم الرصاص	[Pencil]
ممحاة	[Eraser/rubber]
مسح	[Erase]
ألصق	[Glue]
ملك	[King]
ولي العهد	[Crown prince]
أمير	[Prince]
أميرة	[Princess]
العائلة الملكية	[Royal family]
القصر الملكي	[Royal palace]
الخطاب الملكي	[Royal speech]
حكومة	[Gevernment]
الوزير الأول	[Prime minister]
قانون	[Law]
مؤسسة محمد الخامس	[Mohamed 6th Foundation]
مركز الشرطة	[Police station]
وزير	[Minister]
المجلس الوزاري	[Ministery council]
المجلس الحكومي	[Governmental council]
السنة التشريعية	[Legeslative year]
برلمان	[Parliament]
سفارة	[Embassy]
ضمان إجتماعي	[Social insurance]
انتخاب - اقتراع	[Election]
نظيف	[Clean]
وسخ	[Dirty]
حر - طليق	[Free]
سهل	[Easy]
صعب	[Difficult]
أنيق	[Elegant]
بارز	[Clear]
ساه	[Absent-minded]
مماثل	[Similar]
متعب	[Tired]
محايد	[Neutral]
معتاد	[Used to]
مماثل	[Similar]
مريض	[Sick]
منتهي الصلاحية	[Expired]
نتن	[Stinky]
سعيد	[Happy]
عادي	[Usual]
بالي	[Old/worn out]
قاس	[Harsh]
أغمض	[Close]
أقسم	[Swear]
أوقع	[Drop]
تاه	[Lost]
شنق	[Hang up]
صبغ الأظافر	[Nail polish]
صفق	[Applaud]
مزق	[Tear]
نسخ	[Copy]
نفخ	[Blow]
نوم	[Sleeping]
ضرب	[Beat]
ضاع	[Lost]
عطش - ظمأ	[Thirst]
جريمة	[Crime]
مات	[Die]
سمع	[Hear]
نام	[Sleep]
لحق	[Catch up with]
معا	[Together]
فرق	[Difference]
ماضي	[Past]
فتح	[Open]
لمس	[Touch]
أطروحة	[Thesis]
أنتن	[You]
مغلق	[Close]
مزج	[Mix]
ماذا يحدث	[What's up]
شيء	[Thing/stuff]
أصبح	[Become]
وضع	[Put]
ترك - تخلى	[Let]
دعني	[Let me]
أسس - بنى	[Construct/build]
نقل	[Transport]
غادر	[Leave]
بترول	[Oil]
أسطوانة	[Disc]
سجارة	[Cigarette]
عداد	[Counter]
عربة رضيع	[Baby stroller]
عطر	[Parfume]
علم - راية	[Flag]
منبه السيارات	[Horn]
سماعة	[Phone]
قرص مدمج	[Disc]
قنديل	[Lamp]
قنينة غاز	[Gaz bottle]
ماء الورد	[Rose water]
مبرد الأظافر	[Nail clipper]
مجمر	[Mejmar/traditional oven]
محراث	[Plow]
مظلة	[Umbrella]
معطر الجو	[Deodorant]
مغناطيس	[Magnet]
قرب	[Near]
شجرة	[Tree]
جرى - عدا	[Run]
قبض	[Catch/arrest]
اختبأ	[Hide]
صرخ	[Yell]
صغير	[Small]
اعتذر	[Apologize]
رف	[Roof]
صابون	[Soap]
جلس	[Sit down]
أثاث	[Furniture]
جائزة	[Prize]
حاضر	[Present]
حسب	[Catculate]
خطأ	[Mistake]
قرأ - تلا	[Read]